11111111111111111111
10000000001100000011
11C000P000000E100001
11111111111111110111