1111111111111111111111111111111111
1100E00000000000000000000000000001
100P0001001000001010010000C0010101
1010010110101010001001000000010101
10000101C000000000000000000C000001
1111111111111111111111111111111111
