11111111111111111111
10000000001100000011
11C000P0000000100001
11111111111111111111