11111111111111111111
11110000001100000011
11C100P000000E100001
11111111111111111111