1111111111111111111111111111111111111111111111111
10000000P0000100000000000000000000000000000000001
10111111111100001111110001E1000000000000000000001
1000000000111110000000000000000000011110000000001
1000000000000010000000C00000000000000010000000001
100000C00011111000000000000000000C001110000000001
1000000000111110000000C00000000000000000000000001
100000000000C0000000111110000000000C0000000000001
1000000000000100000000000000000000000000000000001
1111111111111111111111110110111111111111111111111
1000000000111110000000C00000000000000000000000001
1000000000111110000000C00000000000000000000000001
1000000000111110000000C00000000000000000000000001
1000000000111110000000C00000000000000000000000001
100000000000C000000011111000000000000000000000001
1111111111111111111111111111111111111111111111111