11111111111111111111
10000010001100000011
11C001P100000E100001
11111111111111111111