11111111111111111111
10000000001101000011
11C000P000001E100001
11111111111111111111