11111111111111111111
1000000000110ö000011
11C000P000000E100001
11111111111111111111